###############################################
#*****************#****##**#****#*****##**###*#                               
#*#*###**#**#*##*****####*#***##**************#
#*#*#***#***#*******##****#****#*#*****###***##
#*#*#**##***#*##*****#***##**#*******###******# 
#***#***#*#*#*#*##***##*****##****##*****#***##
#***#*#*#**##*#**#***##***##*****##**********##
#*#*#*#**#**#****#**********##****##*********##
#*#*#*##*#**#*#*****##**##***#****##****#*****#
#****************#*******##*****##******#####*#
#*#*#*##*#**#*#***#***********###*********#***#
#*#***#************#******##****###******##**##
#***#*#**#**#*#*****##***##***##******##*****##
#*****##*********#****************#**##******##
#*#*#***#####*#******###*****##****#****#***###
#*****************#**##**###*********####**####
###############################################      