#################
#***************#            
#*#*###**#**#*###                           
#*#*#***#***#**##                         
#*#*#**##***#*###        
#***#***#*#*#*#*#    
#***#*#*#**##*#*#      
#*#*#*#**#**#***#         
#*#*#*##*#**#*#*#           
#***************#            
#*#*#*##*#**#*#*#                 
#*#***#*********#              
#***#*#**#**#*#*#                  
#*****##********#       
#*#*#***#####*#*#
#***************#
#################      