################
#**************#            
#**###**#**#*###                           
#**#***#***#**##                         
#**#**##***#*###        
#**#***#*#*#*#*#    
#**#*#*#**##*#*#      
#**#*#**#**#***#         
#**#*##*#**#*#*#           
#**************#            
#**#*##*#**#*#*#                 
#****#*********#              
#**#*#**#**#*#*#                  
#**************#       
#**************#
################      