################
#              #            
# ###  #   # ###                           
#  #   # #    ##                         
#  #  ##   # ###        
#  #   # # # # #    
#  # # #  ## # #      
#  # #  #  #   #         
#  # ## #  # # #           
#              #            
#  # ## #  # # #                 
#    #         #              
#  # #  #  # # #                  
#              #       
################      